#############
#N#       #A#
#         # #     
#         # #
#        #  #
#        #  #
#       T#  #
#           #
#############